11111111111
10000000001
13111110111
10000000041
11111010111
10000000001
11111011101
10000000501
16001000001
10000001101
11111111111
